18 18 18 18 18 18 18 18 18 18 18 18 18 18 18 18 18 18 18 18 18 18 18 18 18 18 18 18 18 18 18 18 18 18 18 18 18 18 18 18 18 18 18 18 18 18 18 18 18 18 18 18 18 18 18 18 18 18 18 18 18 18 18 18 18 18 18 18 18 18 18 18 18 18 18 18 18 18 18 18 18 18 18 18 18 18 18 18 18 18 18 18 18 18 18 18 18 18 18 18 
18 18 18 18 18 18 18 18 18 18 18 18 18 18 18 18 18 18 18 18 18 18 18 18 18 18 18 18 18 18 18 18 18 18 18 18 18 18 18 18 18 18 18 18 18 18 18 18 18 18 18 18 18 18 18 18 18 18 18 18 18 18 18 18 18 18 18 18 18 18 18 18 18 18 18 18 18 18 18 18 18 18 18 18 18 18 18 18 18 18 18 18 18 18 18 18 18 18 18 18 
18 18 18 18 18 18 18 18 18 18 18 18 18 18 18 18 18 18 18 18 18 18 18 18 18 18 18 18 18 18 18 18 18 18 18 18 18 18 18 18 18 18 18 18 18 18 18 18 18 18 18 18 18 18 18 18 18 18 18 18 18 18 18 18 18 18 18 18 18 18 18 18 18 18 18 18 18 18 18 18 18 18 18 18 18 18 18 18 18 18 18 18 18 18 18 18 18 18 18 18 
18 18 18 18 18 18 18 18 18 18 18 18 18 18 18 18 18 18 18 18 18 18 18 18 18 18 18 18 19 18 18 18 18 18 18 18 18 18 18 18 18 18 18 18 18 18 18 18 18 18 18 18 18 18 18 18 18 18 18 18 18 18 18 18 18 18 18 18 18 18 18 18 18 18 18 18 18 18 18 18 18 18 18 18 18 18 18 18 18 18 18 18 18 18 18 18 18 18 18 18 
18 18 18 18 18 18 18 18 18 18 18 18 18 18 18 18 18 18 18 18 18 18 18 18 18 18 18 18 18 18 18 18 18 18 18 18 18 18 18 18 18 18 18 18 18 18 18 18 18 18 18 18 18 18 18 18 18 18 18 18 18 18 18 18 18 18 18 18 18 18 18 18 18 18 18 18 18 18 18 18 18 18 18 18 18 18 18 18 18 18 18 18 18 18 18 18 18 18 18 18 
18 18 18 18 18 18 18 18 18 18 18 18 18 18 18 18 18 18 18 18 18 18 18 18 18 18 18 18 18 18 18 18 18 18 18 18 18 18 18 18 18 18 18 18 18 18 18 18 18 18 18 18 18 18 18 18 18 18 18 18 18 18 18 18 18 18 18 18 18 18 18 18 18 18 18 18 18 18 18 18 18 18 18 18 18 18 18 18 18 18 18 18 18 18 18 18 18 18 18 18 
18 18 18 18 18 18 19 18 18 18 18 18 18 18 18 18 18 18 18 18 18 18 18 18 18 18 18 18 18 18 18 18 18 18 18 18 18 18 18 18 18 18 18 18 18 18 18 18 19 18 18 18 18 18 18 18 18 18 18 18 18 18 18 18 18 18 18 18 18 18 18 18 18 18 18 18 18 18 18 18 18 18 18 18 18 18 18 18 18 18 18 18 18 18 18 18 18 18 18 18 
18 18 18 18 18 18 18 18 18 18 18 18 18 18 18 18 18 18 18 18 18 18 18 18 18 18 18 18 18 18 18 18 18 18 18 18 18 18 18 18 18 18 18 18 18 18 18 18 18 18 18 18 18 18 18 18 18 18 18 18 18 18 18 18 18 18 18 18 18 18 18 18 18 18 18 18 18 18 18 18 18 18 18 18 18 18 18 18 18 18 18 18 18 18 18 18 18 18 18 18 
18 18 18 18 18 18 18 18 18 18 18 18 18 18 18 18 18 18 18 18 19 18 18 18 18 18 18 18 18 18 18 18 18 18 19 18 18 18 18 18 18 18 18 18 18 18 18 18 18 18 18 18 18 18 18 18 18 18 18 18 18 18 18 18 18 18 18 18 18 18 18 18 18 18 18 18 18 18 18 18 18 18 18 18 18 18 18 18 18 18 18 18 18 18 18 18 18 18 18 18 
18 18 18 18 18 18 18 18 18 18 18 18 18 18 18 18 18 18 18 18 18 18 18 18 18 18 18 18 18 18 18 18 18 18 18 18 18 18 18 18 18 18 19 18 18 18 18 18 18 18 18 18 18 18 18 18 18 18 18 18 18 18 18 18 18 18 18 18 18 18 18 18 18 18 18 18 18 18 18 18 18 18 18 18 18 18 18 18 18 18 18 18 18 18 18 18 18 18 18 18 
18 18 18 18 18 18 18 18 18 18 18 18 18 18 18 18 18 18 18 18 18 18 18 18 18 18 18 18 18 18 18 18 18 18 18 18 18 18 18 18 18 18 18 18 18 18 18 18 18 18 18 18 18 18 18 18 18 18 18 18 18 18 18 18 18 18 18 18 18 18 18 18 18 18 18 18 18 18 18 18 18 18 18 18 18 18 18 18 18 18 18 18 18 18 18 18 18 18 18 18 
18 18 18 18 18 18 18 18 18 18 18 18 18 18 18 18 18 18 18 18 18 18 18 18 18 18 18 18 18 18 18 18 18 18 18 18 18 18 18 18 18 18 18 18 18 18 18 18 18 18 18 18 19 18 18 18 18 18 18 18 19 18 18 18 18 18 18 18 18 18 18 18 18 18 18 18 18 18 18 18 18 18 18 18 18 18 18 18 18 18 18 18 18 18 18 18 18 18 18 18 
18 18 18 18 18 18 18 18 18 18 18 18 18 18 18 18 18 18 18 18 18 18 18 18 18 18 18 18 18 18 18 18 18 18 18 18 18 18 18 18 18 18 18 18 18 18 18 18 18 18 18 18 18 18 18 18 18 18 18 18 18 18 18 18 18 18 18 18 18 18 18 18 18 18 18 18 18 18 18 18 18 18 18 18 18 18 18 18 18 18 18 18 18 18 18 18 18 18 18 18 
18 18 18 18 18 18 18 18 18 18 18 19 18 18 18 18 18 18 18 18 18 18 18 18 19 18 18 18 18 18 18 18 18 18 18 18 18 18 18 18 18 18 28 26 26 26 26 26 26 26 26 29 18 18 18 18 18 18 18 18 18 18 18 18 18 18 18 18 18 18 18 19 18 18 18 18 18 18 18 18 18 18 18 18 18 18 18 18 18 19 18 18 18 18 18 18 18 18 18 18 
18 18 18 18 18 18 18 18 18 18 18 18 18 18 18 18 18 18 18 18 18 18 18 18 18 18 18 18 18 18 18 18 18 18 19 18 18 18 18 18 28 26 27 1 1 1 1 2 1 1 1 25 29 18 18 18 18 18 18 18 18 18 18 18 18 18 18 18 18 18 18 18 18 18 18 18 18 18 18 18 18 18 18 18 18 18 18 18 18 18 18 18 18 18 18 18 18 18 18 18 
18 18 18 18 18 18 18 18 18 18 18 18 18 18 18 18 18 18 18 18 18 18 18 18 18 18 18 18 18 18 18 18 18 18 18 18 18 18 18 28 27 1 1 1 1 1 1 1 1 1 1 1 25 26 29 18 18 18 19 18 18 18 18 18 18 18 18 18 18 18 18 18 18 18 18 18 18 18 18 18 18 18 18 18 18 18 18 18 18 18 18 18 18 18 18 18 18 18 18 18 
18 18 19 18 18 18 18 18 18 18 18 18 18 18 18 18 18 18 18 18 18 18 18 18 18 18 18 18 18 18 18 18 18 18 18 18 18 18 28 27 1 1 1 1 1 1 1 1 1 1 1 1 1 1 23 18 18 18 18 18 18 18 18 18 18 18 18 18 18 18 18 18 18 18 18 18 18 18 18 18 18 18 19 18 18 18 18 18 18 18 18 18 18 18 18 18 18 18 18 18 
18 18 18 18 18 18 18 18 18 18 18 18 18 18 18 18 18 18 18 18 18 18 18 18 18 18 18 18 18 18 18 18 18 18 18 18 18 18 24 1 2 1 1 16 16 16 16 16 16 16 1 1 1 1 25 29 18 18 18 18 18 18 18 18 18 18 18 18 18 18 18 18 18 18 18 18 18 18 18 18 18 18 18 18 18 18 18 18 18 18 18 18 18 18 18 18 18 18 18 18 
18 18 18 18 18 18 18 18 18 18 18 18 18 19 18 18 18 18 18 18 19 18 18 18 18 18 18 18 18 18 18 18 18 18 18 18 18 18 24 1 1 1 16 16 1 1 1 1 16 16 16 1 1 1 1 25 26 26 26 26 26 26 29 18 18 18 18 19 18 18 18 18 18 18 18 19 18 18 18 18 18 18 18 18 18 18 18 18 18 18 18 18 19 18 18 18 18 18 18 18 
18 18 18 18 18 18 18 18 18 18 18 18 18 18 18 18 18 18 18 18 18 18 18 18 18 19 18 18 18 18 18 18 19 18 18 18 18 18 24 1 1 1 16 1 1 1 1 1 1 1 16 16 1 1 1 1 1 1 1 1 1 1 25 29 18 18 18 18 18 18 18 18 18 18 18 18 18 18 18 28 26 26 26 26 26 26 26 26 26 29 18 18 18 18 18 18 18 19 18 18 
18 18 18 18 18 18 18 19 18 18 18 28 26 26 26 26 26 26 26 29 28 26 26 26 29 18 18 18 18 18 18 18 18 18 18 18 18 18 24 1 1 16 16 1 1 1 1 1 1 1 1 16 1 1 1 1 1 1 1 1 1 1 1 25 26 29 18 18 18 18 18 18 18 18 18 18 18 18 28 27 1 1 1 1 1 1 1 1 1 25 26 29 18 18 18 18 18 18 18 18 
18 18 18 18 18 18 18 18 18 18 28 27 1 1 1 1 1 1 1 25 27 1 1 1 25 26 26 29 18 18 18 18 18 18 18 18 18 18 24 1 1 16 1 1 1 20 21 21 22 1 1 1 1 1 1 1 16 16 16 16 16 16 1 1 1 25 29 18 18 18 18 18 18 18 18 18 28 26 27 1 1 1 1 1 1 1 1 1 1 1 1 25 29 18 18 18 18 18 18 18 
18 18 18 18 18 18 18 18 18 18 24 1 1 2 1 1 1 1 1 1 1 16 16 16 1 1 1 25 29 18 18 18 18 18 18 18 18 18 24 1 1 1 1 1 20 31 18 18 30 22 1 1 1 1 1 1 1 16 16 16 1 16 16 1 1 1 23 18 18 18 18 18 18 18 18 28 27 1 1 1 1 16 1 1 20 21 21 22 1 1 1 1 23 18 18 18 18 18 18 18 
18 18 18 18 18 18 18 18 18 18 24 1 1 1 1 1 1 2 1 1 1 1 1 16 16 16 1 1 23 18 18 18 18 18 18 18 18 18 30 22 1 1 1 1 25 29 18 18 18 30 22 1 1 1 2 1 1 1 1 1 1 1 16 1 1 1 23 18 18 18 18 18 18 18 28 27 1 1 1 1 16 16 1 20 31 18 18 30 22 1 1 1 25 29 18 18 18 18 18 18 
18 18 18 18 19 18 18 18 18 18 24 1 1 1 1 1 1 1 1 1 1 1 1 1 1 1 1 1 23 18 18 18 18 18 19 18 18 18 18 24 1 1 1 1 1 25 26 29 18 18 30 22 1 1 1 1 1 1 1 1 1 1 16 1 1 1 23 18 18 18 18 18 18 28 27 1 1 1 1 16 16 1 1 23 18 18 18 18 24 1 1 1 1 23 18 18 18 18 18 18 
18 18 18 18 18 18 18 18 18 28 27 32 3 32 32 32 32 32 32 32 32 32 32 32 32 32 32 32 23 18 18 18 18 18 18 18 18 19 18 24 1 1 1 1 1 1 1 25 26 26 29 24 1 1 1 1 1 1 1 1 1 16 16 1 2 1 23 18 19 18 18 18 28 27 1 1 1 16 16 16 1 1 1 23 18 18 18 28 27 1 1 1 1 23 18 18 18 18 18 18 
18 18 18 18 18 18 18 18 28 27 1 32 3 32 3 3 3 3 3 3 32 3 3 3 3 3 3 32 25 26 26 29 18 18 18 18 18 18 18 24 1 1 1 2 1 1 1 1 1 1 25 27 1 1 1 1 1 1 1 1 16 16 1 1 1 1 23 18 18 18 18 18 24 1 1 1 16 16 1 1 1 1 1 25 29 18 28 27 1 1 1 1 1 23 18 18 18 19 18 18 
18 18 18 18 18 18 18 28 27 1 1 32 3 32 3 32 32 32 32 3 32 3 32 32 32 32 3 32 1 1 1 25 26 29 18 18 18 18 18 24 1 1 1 1 1 1 1 1 1 1 1 1 12 10 10 10 13 1 1 1 16 1 1 1 1 20 31 18 18 18 18 28 27 1 1 1 16 1 1 1 1 1 1 1 25 26 27 1 1 1 2 1 1 23 18 18 18 18 18 18 
18 18 18 18 18 28 26 27 1 1 1 32 3 32 3 3 32 3 32 3 32 3 32 3 3 3 3 32 1 1 1 1 1 25 26 29 18 18 18 30 22 1 1 1 1 1 1 1 1 1 1 12 11 3 3 3 9 13 1 1 1 1 1 1 20 31 18 19 18 28 26 27 1 1 1 1 1 1 1 1 2 1 1 1 1 1 1 1 1 1 1 1 1 23 18 18 18 18 18 18 
18 18 18 18 28 27 1 1 1 1 1 32 3 32 32 3 32 3 32 3 32 3 32 3 32 3 32 32 1 1 1 1 1 1 1 25 29 18 18 18 30 22 1 1 1 1 1 1 1 1 12 11 3 3 3 3 3 7 1 1 1 1 1 20 31 18 18 18 28 27 1 1 1 1 1 1 1 1 1 1 1 1 1 1 1 1 1 1 1 1 1 1 1 23 18 18 18 18 18 18 
18 18 18 28 27 1 1 1 1 1 1 32 3 3 3 3 32 3 32 3 3 3 32 3 32 3 3 32 1 1 12 10 10 13 1 1 23 18 19 18 18 30 22 1 1 1 1 1 2 1 8 3 3 3 3 3 3 7 1 2 1 1 20 31 18 18 18 28 27 1 1 1 1 1 1 1 1 1 1 1 1 1 1 1 1 1 1 1 1 1 1 1 20 31 18 18 18 18 18 18 
18 18 18 24 1 1 1 1 1 1 1 32 3 32 32 32 32 3 32 32 32 32 32 3 32 32 3 32 1 12 11 3 3 9 13 1 25 29 18 18 18 18 30 22 1 1 1 1 1 12 11 3 3 3 3 3 4 15 1 1 1 20 31 18 18 18 28 27 1 1 16 16 1 1 1 2 1 1 1 1 1 1 1 1 1 1 2 1 1 1 1 20 31 18 18 18 18 18 18 18 
18 18 18 24 1 1 1 2 1 1 1 32 3 3 3 3 3 3 3 3 3 3 3 3 3 32 3 32 1 8 3 3 3 3 9 13 1 23 18 18 18 18 18 24 1 1 1 1 1 8 3 3 3 3 3 4 15 1 1 1 1 23 18 18 18 28 27 1 1 16 16 1 1 1 1 1 1 1 1 1 1 1 1 1 1 1 1 1 1 1 20 31 18 18 18 18 18 18 18 18 
18 18 28 27 1 1 1 1 1 1 1 32 32 32 32 32 32 32 3 32 32 32 32 32 32 32 3 32 1 8 3 3 3 3 3 7 1 25 29 18 18 19 18 30 22 1 1 1 1 8 3 3 3 3 3 7 1 1 1 1 20 31 18 18 18 24 1 1 1 16 1 1 1 1 1 1 1 1 1 1 1 1 1 1 1 1 1 1 20 21 31 18 19 18 18 18 18 18 19 18 
18 18 24 1 1 1 1 1 1 1 1 32 3 3 3 3 3 32 3 32 3 3 3 3 3 3 3 32 1 8 3 3 3 3 3 7 1 1 23 18 18 18 18 18 24 1 1 1 1 8 3 3 3 4 5 15 1 1 1 20 31 18 18 18 18 24 1 1 1 16 1 1 1 1 1 1 1 16 16 1 1 2 1 1 1 1 1 20 31 18 18 18 18 18 18 18 18 18 18 18 
18 18 24 1 1 1 1 1 1 1 1 32 3 32 32 32 3 32 32 32 3 32 32 32 32 32 32 32 1 8 3 3 3 3 3 7 1 1 23 18 18 18 18 18 24 1 1 1 1 14 5 5 5 15 1 1 1 1 1 23 18 18 18 19 18 24 1 1 1 16 16 16 1 1 1 16 16 16 1 1 1 1 1 1 20 22 1 23 18 28 26 26 26 26 26 26 29 18 18 18 
18 18 24 1 1 1 2 1 1 1 1 32 3 3 3 32 3 3 3 3 3 32 3 3 3 3 3 32 1 8 3 3 3 3 3 7 16 1 23 18 18 18 18 18 30 22 1 1 1 1 1 1 1 1 1 1 1 20 21 31 18 18 18 18 18 24 1 1 1 1 1 16 16 16 16 16 1 1 1 1 1 1 1 20 31 24 1 23 28 27 1 1 1 1 1 1 25 29 18 18 
18 18 24 1 1 1 1 1 1 1 1 32 32 32 3 32 32 32 32 32 32 32 3 32 32 32 3 32 1 8 3 3 3 3 3 1 16 1 23 18 18 18 18 18 18 24 1 1 1 1 1 1 2 1 1 1 20 31 18 18 18 18 18 18 18 30 22 1 1 1 1 1 1 1 1 1 1 1 1 1 20 21 21 31 18 24 1 25 27 1 16 16 16 1 1 1 1 23 18 18 
18 18 30 22 1 1 1 1 1 1 1 32 3 32 3 3 3 3 3 3 3 32 3 32 3 3 3 32 1 14 6 3 3 3 4 16 16 1 23 18 19 18 18 18 18 30 21 22 1 1 1 1 1 1 1 20 31 18 18 18 18 18 18 18 18 18 30 21 22 1 1 1 1 1 1 1 1 1 20 21 31 18 18 18 28 27 1 1 1 16 16 1 1 1 1 1 1 23 18 18 
18 18 18 24 1 1 1 1 1 1 1 32 3 32 32 32 32 32 32 32 3 32 3 32 3 32 32 32 1 1 8 3 3 3 7 16 1 1 23 18 18 18 18 18 18 18 18 24 1 1 1 1 16 20 21 31 18 18 19 18 18 18 18 18 19 18 18 18 30 21 21 21 21 21 21 21 21 21 31 18 18 18 18 28 27 1 1 1 16 16 1 1 1 1 1 2 1 23 18 18 
18 18 18 30 22 1 1 1 1 1 1 32 3 3 3 3 3 3 3 3 3 3 3 32 3 3 3 32 1 1 14 5 5 5 15 16 1 20 31 18 18 18 18 18 19 18 18 30 21 22 16 1 16 23 18 18 18 18 18 18 18 18 18 18 18 18 18 18 18 18 18 18 18 18 18 18 18 18 18 18 18 18 28 27 1 1 16 16 16 1 1 1 1 1 1 1 1 23 19 18 
18 18 18 18 24 1 1 1 1 1 1 32 32 32 32 32 32 32 32 32 32 32 32 32 32 32 3 32 1 1 1 1 1 1 16 16 1 23 18 18 18 18 18 18 18 18 18 18 28 27 1 1 1 25 29 18 18 18 18 18 18 18 18 18 18 18 18 18 18 18 19 18 18 18 18 18 18 18 18 18 18 28 27 1 1 16 16 1 1 2 1 1 1 1 1 1 1 23 18 18 
18 18 18 18 24 1 1 1 1 2 1 1 1 1 1 1 1 1 1 1 1 1 1 1 1 8 3 7 1 1 2 1 1 16 16 1 1 23 18 18 18 19 18 18 18 18 28 26 27 1 1 1 1 1 25 26 26 26 26 26 26 26 26 26 26 26 26 26 29 18 18 18 18 18 18 18 18 18 18 18 18 24 1 1 1 16 16 1 1 1 1 1 2 1 1 1 1 23 18 18 
18 18 18 18 30 22 1 1 1 1 1 1 1 1 1 1 1 2 1 1 1 1 1 2 1 8 3 7 1 1 1 1 1 16 1 20 21 31 18 18 18 18 18 18 18 28 27 1 1 1 1 1 1 1 1 1 1 1 2 1 1 1 1 1 1 1 1 1 25 29 18 18 18 18 18 18 18 19 18 18 18 24 1 1 16 16 1 1 1 1 1 1 1 1 1 1 20 31 18 18 
18 18 18 18 18 24 1 1 1 1 1 1 16 1 1 1 1 1 1 1 1 1 1 1 1 8 3 7 1 1 1 1 1 1 1 23 18 18 18 18 18 18 18 28 26 27 1 1 1 16 16 16 16 16 1 1 1 1 1 1 1 1 1 1 1 2 1 1 1 23 18 18 18 18 18 18 18 18 18 18 18 24 1 1 1 1 1 1 1 1 1 1 20 21 21 21 31 18 18 18 
18 18 18 18 18 30 22 1 1 1 1 16 16 1 1 1 12 10 10 10 10 10 10 10 10 11 3 7 1 1 1 1 1 1 20 31 18 19 18 18 18 18 28 27 1 1 1 1 16 16 16 16 16 1 1 1 1 16 16 16 16 16 16 1 1 1 1 1 1 25 29 18 18 18 18 18 18 18 18 18 18 24 1 1 1 1 1 1 1 1 20 21 31 18 18 18 18 18 18 18 
18 18 18 18 18 18 30 22 1 1 16 16 1 1 12 10 11 3 3 3 3 3 3 3 3 3 3 7 1 1 1 1 1 20 31 18 18 18 18 18 28 26 27 1 1 1 2 1 16 16 1 1 1 1 1 1 16 16 16 16 16 16 16 16 16 1 1 1 1 1 25 29 18 18 18 18 18 18 18 28 26 27 1 1 1 1 2 1 1 20 31 18 18 18 18 18 18 19 18 18 
18 18 18 18 18 18 18 24 1 1 16 1 1 12 11 3 3 3 3 3 3 3 3 3 3 3 3 7 1 1 1 1 20 31 18 18 18 18 28 26 27 1 1 12 10 10 10 13 1 1 1 1 1 2 1 1 16 16 16 16 16 16 16 16 16 1 1 1 1 1 1 33 34 34 34 34 34 34 34 35 1 16 1 1 1 1 1 1 1 23 18 18 18 18 18 18 18 18 18 18 
18 18 18 18 18 18 18 24 1 1 16 1 1 8 3 3 3 3 3 3 3 3 3 3 3 3 3 7 1 2 1 1 25 26 26 26 26 26 27 1 1 12 10 11 3 3 3 7 1 1 1 1 1 1 1 1 1 1 1 1 16 16 16 16 16 1 1 2 1 1 1 33 34 34 34 34 34 34 34 35 1 1 1 1 1 1 1 1 20 31 18 18 19 18 18 18 18 18 18 18 
18 18 18 18 18 18 28 27 1 16 16 1 1 8 3 3 3 3 3 3 3 3 3 3 3 3 4 15 1 1 1 1 1 16 16 16 16 16 1 1 12 11 3 3 3 3 3 7 1 1 1 1 1 1 1 20 21 21 22 1 1 1 1 1 1 1 1 1 1 1 1 33 34 34 34 34 34 34 34 35 1 16 1 1 1 1 1 1 23 18 18 18 18 18 18 18 18 18 18 18 
18 18 18 18 18 28 27 1 1 16 16 1 1 14 6 3 3 3 3 3 3 3 3 3 3 4 15 1 1 1 1 1 1 1 1 16 16 1 1 1 8 3 3 3 3 3 4 15 1 1 1 1 1 1 20 31 18 28 27 1 1 1 1 1 1 1 1 1 1 1 20 31 18 18 18 18 18 18 18 30 21 22 1 1 1 1 1 1 23 18 18 18 18 18 18 18 18 18 18 18 
18 18 18 18 18 24 1 1 1 1 16 1 1 1 14 5 6 3 3 3 3 3 3 3 4 15 1 1 1 1 1 1 1 2 1 1 1 1 1 2 8 3 3 3 4 5 15 1 1 1 1 1 1 1 25 26 26 27 1 1 1 1 1 2 1 1 1 1 20 21 31 18 18 18 18 18 18 18 18 18 18 24 1 1 1 1 1 1 23 18 18 18 18 18 19 18 18 18 18 18 
18 18 18 18 18 24 1 1 1 1 16 16 1 1 1 12 11 3 4 5 5 5 5 5 15 1 1 1 1 1 1 1 1 1 16 16 16 1 1 1 14 5 5 5 15 1 1 1 1 1 1 1 1 1 1 1 1 1 1 1 1 1 1 1 1 1 20 21 31 18 18 18 18 18 18 19 18 18 18 18 28 27 1 1 2 1 1 1 23 18 18 18 18 18 18 18 18 18 18 18 
18 18 18 18 18 24 1 1 1 1 1 16 16 12 10 11 3 3 7 1 1 1 1 1 1 1 2 1 1 1 1 1 1 1 20 21 21 22 1 1 1 1 1 1 1 1 1 1 2 1 1 1 2 1 1 1 1 1 1 1 20 21 21 21 21 21 31 18 18 18 18 18 18 18 18 18 18 18 28 26 27 1 1 1 1 1 1 1 23 18 18 18 18 18 18 18 18 18 18 18 
18 18 18 18 18 24 1 12 10 10 10 10 10 11 3 3 3 4 15 1 1 1 2 1 1 1 1 1 1 1 1 1 1 1 25 29 18 30 22 1 1 1 1 1 1 1 1 1 1 1 1 1 1 1 1 1 1 1 20 21 31 18 18 18 18 18 18 18 19 18 18 18 18 18 18 18 18 28 27 1 1 1 1 1 1 1 1 1 23 18 18 18 18 18 18 18 18 18 18 18 
18 18 18 18 18 30 22 8 3 3 3 3 3 3 3 4 5 15 1 1 1 1 1 1 1 1 1 1 1 1 16 16 1 1 1 25 29 18 30 21 21 21 22 1 1 1 1 1 1 1 1 1 1 1 1 1 1 20 31 18 18 28 26 26 26 29 18 18 18 18 18 18 18 18 18 28 26 27 1 1 1 1 1 1 1 1 1 1 23 18 18 19 18 18 18 18 18 18 18 18 
18 18 18 18 18 28 27 8 3 4 5 5 5 5 5 15 1 1 1 1 1 1 1 2 1 1 1 1 1 1 1 16 1 2 1 1 25 26 29 18 18 18 30 21 21 21 21 22 1 1 1 1 1 1 1 20 21 31 18 28 26 27 1 1 1 25 29 18 18 18 19 18 18 28 26 27 1 1 1 1 1 1 1 1 1 1 1 1 25 29 18 18 18 18 18 18 18 18 18 18 
18 18 18 28 26 27 1 32 3 32 32 32 32 32 32 32 32 32 32 32 32 32 32 32 1 1 1 1 1 1 1 16 16 1 1 1 1 1 25 29 18 19 18 18 18 18 18 24 1 1 1 1 20 21 21 31 18 28 26 27 1 1 1 1 1 1 25 29 18 18 18 18 28 27 1 1 1 1 1 1 1 1 1 1 1 2 1 1 1 25 29 18 18 18 18 18 18 18 18 18 
18 18 18 24 1 1 1 32 3 32 3 3 3 32 3 3 3 3 3 3 3 3 3 32 1 1 1 1 2 1 1 1 16 16 16 1 1 1 1 25 29 18 18 18 18 19 18 24 1 2 1 1 23 18 18 28 26 27 1 1 1 16 16 16 16 1 1 23 18 18 18 18 24 1 1 1 1 1 1 1 1 1 1 1 1 1 1 1 1 1 25 26 29 18 18 18 18 19 18 18 
18 18 28 27 1 1 1 32 3 32 3 32 3 32 32 32 32 32 32 32 32 32 3 32 1 1 1 1 1 1 1 1 1 1 16 1 1 1 1 1 23 18 18 18 18 18 18 24 1 1 1 1 25 26 26 27 1 1 1 1 16 16 1 1 16 1 1 25 29 18 18 28 27 1 1 1 1 1 1 2 1 1 1 1 1 1 1 1 1 1 1 1 23 18 18 18 18 18 18 18 
18 18 24 1 1 2 1 32 3 3 3 32 3 3 3 3 3 3 3 3 32 3 3 32 1 1 1 1 1 1 1 1 1 1 16 1 1 1 1 1 23 18 18 18 18 18 28 27 1 1 1 1 1 1 1 1 1 1 2 1 1 1 1 1 16 16 1 1 23 18 18 24 1 1 1 1 1 1 1 1 1 1 1 1 1 16 16 16 16 1 1 1 23 18 18 18 18 18 18 18 
18 28 27 1 1 1 1 32 32 32 32 32 3 32 32 32 32 32 32 32 32 3 32 32 1 1 1 1 1 1 1 1 1 16 16 1 1 1 1 20 31 18 18 19 18 28 27 1 1 1 1 1 12 10 10 10 10 10 10 10 10 10 13 1 1 16 1 1 23 18 18 24 1 1 2 1 1 1 1 1 1 1 1 1 1 16 16 16 16 1 1 1 23 18 18 18 18 18 18 18 
18 24 1 1 1 1 1 32 3 3 3 32 3 3 3 3 3 3 32 3 3 3 3 32 1 1 1 2 1 1 1 1 16 16 1 1 1 1 1 23 18 18 18 18 28 27 1 1 1 1 12 10 11 3 3 3 3 3 3 3 3 3 9 10 13 1 2 1 25 29 18 24 1 1 1 1 1 1 1 1 1 1 1 1 16 16 16 16 1 1 2 1 23 18 19 18 18 18 18 18 
18 24 1 1 1 1 1 32 3 32 3 32 32 32 32 32 32 3 32 3 32 32 32 32 1 1 1 1 1 1 1 16 16 1 1 1 1 1 20 31 18 18 28 26 27 1 1 1 2 12 11 3 3 3 3 3 3 3 3 3 3 3 3 3 9 13 1 1 1 25 29 24 1 1 1 1 1 1 1 1 1 1 16 16 16 16 16 1 1 1 1 1 23 18 18 18 18 18 18 18 
18 24 1 1 1 1 1 32 3 32 3 32 3 3 3 3 3 3 3 3 3 3 3 32 1 1 1 1 1 1 1 16 1 1 1 1 1 20 31 18 19 28 27 1 1 1 1 12 10 11 3 3 3 3 3 3 3 3 3 3 3 3 3 3 3 7 1 1 1 1 23 30 22 1 1 1 1 1 2 1 1 1 16 16 16 16 1 1 1 1 1 20 31 18 18 18 18 18 18 18 
18 24 1 2 1 1 1 32 3 32 32 32 3 32 3 32 32 32 32 32 32 32 3 32 1 1 1 1 1 1 16 16 1 1 1 20 21 31 18 18 28 27 1 1 1 12 10 11 3 3 3 3 3 3 3 4 5 5 5 5 5 5 5 5 5 15 1 1 1 1 25 29 30 22 1 1 1 1 1 1 1 1 16 16 16 1 1 1 1 20 21 31 18 18 18 18 18 18 18 18 
18 24 1 1 1 1 1 32 3 32 3 3 3 32 3 3 3 32 3 3 3 32 3 32 1 1 1 1 1 1 1 1 1 1 20 31 18 28 26 26 27 1 1 1 12 11 3 3 3 3 3 3 3 4 5 15 1 1 1 1 1 1 1 1 1 1 1 1 2 1 1 23 18 30 22 1 1 1 1 1 1 1 1 1 1 1 2 1 1 23 18 18 18 18 18 18 18 18 18 18 
18 24 1 1 1 1 1 32 3 32 3 32 32 32 32 32 3 32 3 32 3 32 3 32 1 1 1 1 1 1 1 1 20 21 31 19 28 27 1 1 1 1 1 1 8 3 3 3 3 3 3 4 5 15 1 1 20 21 21 21 21 22 1 1 2 1 1 1 1 1 1 23 18 18 30 21 21 21 22 1 1 1 1 1 1 1 1 1 1 23 18 18 18 18 18 18 18 18 18 18 
18 24 1 1 1 1 1 32 3 32 3 32 3 3 3 3 3 32 3 32 3 32 3 32 1 1 1 1 1 1 20 21 31 18 28 26 27 1 1 1 1 1 2 1 8 3 3 3 3 3 4 15 1 2 20 21 31 18 18 18 18 30 21 22 1 1 1 1 1 1 1 23 18 18 18 18 18 18 30 21 21 21 22 1 1 1 1 1 20 31 18 18 18 18 18 19 18 18 18 18 
18 24 1 16 1 2 1 32 3 32 3 32 3 32 32 32 32 32 3 32 3 32 3 32 1 2 1 1 1 20 31 18 18 28 27 1 1 1 1 1 1 1 1 1 14 5 5 5 5 5 15 1 1 20 31 18 18 18 18 18 18 18 18 30 22 1 1 1 1 1 1 23 18 18 18 18 18 18 18 18 18 18 30 21 21 21 21 21 31 18 18 18 18 18 18 18 18 18 18 18 
18 24 1 16 1 1 1 32 3 32 3 32 3 3 3 3 3 32 3 32 3 32 3 32 1 1 1 1 1 23 18 28 26 27 1 1 1 16 1 1 1 1 1 1 1 2 1 1 1 1 1 20 21 31 18 18 18 18 18 19 18 18 18 18 24 1 1 1 2 1 1 23 18 18 18 18 18 18 19 18 18 18 18 18 18 18 18 18 18 18 18 18 18 18 18 18 18 18 18 18 
18 24 1 16 1 1 1 32 3 32 3 32 32 32 32 32 32 32 3 32 3 32 32 32 1 1 1 1 20 31 19 24 1 1 1 1 16 16 1 2 1 1 1 1 1 1 1 16 1 1 20 31 18 18 18 18 18 18 18 18 18 18 18 18 24 1 1 1 1 1 20 31 18 18 18 18 18 18 18 18 18 18 18 18 18 18 18 18 18 19 18 18 18 18 18 18 18 18 18 18 
18 24 1 16 1 1 1 32 3 3 3 3 3 3 3 3 3 3 3 32 3 3 3 32 1 1 1 1 23 18 18 24 1 2 1 1 16 16 1 1 1 1 16 16 16 1 16 16 1 1 23 18 18 18 18 18 18 18 18 18 18 18 18 18 30 21 21 21 21 21 31 18 18 18 18 18 18 18 18 18 18 18 18 19 18 18 18 18 18 18 18 18 18 18 18 18 18 18 18 18 
18 24 1 16 16 1 1 32 32 32 32 32 32 32 32 32 32 32 32 32 32 32 3 32 1 1 1 1 23 18 18 24 1 1 1 1 16 16 1 1 16 16 16 16 16 16 1 1 1 20 31 18 18 18 19 18 18 18 18 18 18 18 19 18 18 18 18 18 18 18 18 18 18 18 19 18 18 18 18 18 18 18 18 18 18 18 18 18 18 18 18 18 18 18 18 18 18 18 18 18 
18 30 22 1 16 1 1 3 3 3 3 3 3 3 3 3 3 3 3 3 3 3 3 32 1 1 1 1 25 29 18 24 1 1 1 1 1 16 16 16 16 1 1 1 1 1 1 1 1 23 18 18 18 18 18 18 18 18 18 18 18 18 18 18 18 18 18 18 18 18 18 18 18 18 18 18 18 18 18 18 18 18 18 18 18 18 18 18 18 18 18 18 18 18 18 18 18 18 18 18 
18 18 24 1 1 1 1 32 32 32 32 32 32 32 32 32 32 32 32 32 32 32 32 32 1 1 1 1 1 25 29 30 22 1 1 1 1 1 1 1 1 1 1 20 21 21 21 21 21 31 18 18 18 18 18 18 18 18 18 18 18 18 18 18 18 18 18 18 18 18 18 18 18 18 18 18 18 18 18 18 18 18 18 18 18 18 18 18 18 18 18 18 18 18 18 18 18 18 18 18 
18 18 30 21 21 21 22 1 1 1 1 1 1 1 1 1 1 1 1 1 1 1 1 1 1 1 1 1 1 1 23 18 30 21 21 21 22 1 1 1 1 1 20 31 18 18 18 18 18 18 18 19 18 18 18 18 18 18 18 18 18 18 18 18 18 18 18 18 18 18 18 18 18 18 18 18 18 18 19 18 18 18 18 18 18 18 18 19 18 18 18 18 18 18 18 18 18 18 18 18 
18 18 18 18 18 28 27 1 1 1 1 1 1 1 1 1 1 1 1 1 1 1 1 1 1 1 2 1 1 1 25 29 18 18 18 18 30 21 21 21 21 21 31 18 18 18 18 18 18 18 18 18 18 18 18 18 18 18 18 18 18 18 18 18 18 18 18 18 18 18 19 18 18 18 18 18 18 18 18 18 18 18 18 18 18 18 18 18 18 18 18 18 18 18 18 18 18 18 18 18 
18 18 18 18 18 24 1 1 1 1 2 1 1 1 20 21 21 21 21 21 21 21 21 22 1 1 1 1 1 1 1 25 26 29 18 19 18 18 18 18 18 18 18 18 18 18 19 18 18 18 18 18 18 18 18 18 18 19 18 18 18 18 18 18 18 18 18 18 18 18 18 18 18 18 18 18 18 18 18 18 18 18 18 18 18 18 18 18 18 18 18 18 18 18 18 18 18 18 18 18 
18 19 18 18 18 24 1 1 1 1 1 1 1 20 31 18 18 18 18 18 28 26 26 27 1 1 1 1 1 1 1 1 1 25 29 18 18 18 18 18 18 18 18 18 18 18 18 18 18 18 18 18 18 18 18 18 18 18 18 18 18 18 18 18 18 18 18 18 18 18 18 18 18 18 18 18 18 18 18 18 18 18 18 18 18 18 18 18 18 18 18 18 18 18 18 18 18 18 18 18 
18 18 18 18 18 24 1 1 1 1 1 1 1 23 18 18 18 18 28 26 27 1 1 1 1 1 1 1 1 1 1 1 1 1 25 26 29 18 18 18 18 19 18 18 18 18 18 18 18 18 18 18 18 18 18 18 18 18 18 18 18 18 18 18 18 18 18 18 18 18 18 18 18 18 18 18 18 18 18 18 18 18 18 18 18 18 18 18 18 18 18 18 18 18 18 18 18 18 18 18 
18 18 18 18 18 24 1 1 1 1 1 1 20 31 18 18 18 28 27 1 12 10 10 10 13 1 1 1 1 1 16 16 16 1 1 1 25 26 29 18 18 18 18 18 18 18 18 18 18 18 18 18 18 18 18 18 18 18 18 18 18 18 18 18 18 18 18 18 18 18 18 18 18 18 18 18 18 18 18 18 18 18 18 18 18 18 18 18 18 18 18 18 18 18 18 18 18 18 18 18 
18 18 18 18 18 24 1 1 1 1 1 1 23 18 18 18 28 27 1 12 11 3 3 3 9 13 1 1 1 1 16 16 16 16 1 1 1 1 25 29 18 18 18 18 18 18 18 18 18 18 19 18 18 18 18 18 18 18 18 18 18 18 18 18 18 18 18 18 18 18 18 18 18 18 18 18 18 18 18 18 18 18 18 18 18 18 18 18 18 18 18 18 18 18 18 18 18 18 18 18 
18 18 18 18 18 30 22 1 1 1 2 1 23 18 18 28 27 1 12 11 3 3 3 3 3 7 1 2 1 1 16 16 16 16 16 16 1 1 1 25 29 18 18 18 18 18 18 18 18 18 18 18 18 18 18 18 18 18 18 18 18 18 18 18 18 18 18 18 18 18 18 18 18 18 18 18 18 18 18 18 18 18 18 18 18 18 18 18 18 18 18 18 18 18 18 18 18 18 18 18 
18 18 18 18 18 18 24 1 1 1 1 1 25 26 26 27 1 12 11 3 3 3 3 3 3 7 1 1 1 1 1 16 16 16 16 16 1 1 2 1 23 18 18 18 18 18 18 18 18 18 18 18 18 18 18 18 18 18 18 18 18 18 18 18 18 18 18 18 18 18 18 18 18 18 18 18 18 18 18 18 18 18 18 18 18 18 18 18 18 18 18 18 18 18 18 18 18 18 18 18 
18 18 18 18 18 18 30 22 1 1 1 1 1 1 1 1 12 11 3 3 3 3 3 3 3 9 13 1 1 1 1 1 16 16 16 16 1 1 1 1 23 18 18 18 19 18 18 18 18 18 18 18 18 18 18 18 18 18 18 18 18 18 18 18 18 18 18 18 18 18 18 18 18 18 18 18 18 18 18 18 18 18 18 18 18 18 18 18 18 18 18 18 18 18 18 18 18 18 18 18 
18 18 18 19 18 18 18 30 22 1 1 1 1 1 1 1 8 3 3 3 3 3 3 3 3 3 7 1 1 1 1 1 1 16 16 16 16 1 1 1 23 18 18 18 18 18 18 18 18 18 18 18 18 18 18 18 18 18 18 18 18 18 18 18 18 18 18 18 18 18 18 18 18 18 18 18 18 18 18 18 18 18 18 18 18 18 18 18 18 18 18 18 18 18 18 18 18 18 18 18 
18 18 18 18 18 18 18 18 30 22 1 1 1 1 1 1 8 3 3 3 3 3 3 3 3 3 7 1 1 1 1 1 1 16 16 16 16 1 1 1 23 18 18 18 18 18 18 19 18 18 18 18 18 18 18 18 18 18 18 18 18 18 18 18 18 18 18 18 18 18 18 18 18 18 18 18 18 18 18 18 18 18 18 18 18 18 18 18 18 18 18 18 18 18 18 18 18 18 18 18 
18 18 18 18 18 18 18 18 18 24 1 1 1 1 1 1 14 6 3 3 3 3 3 3 3 3 7 1 1 2 1 1 1 16 16 16 16 1 1 1 23 18 18 18 18 18 18 18 18 18 18 18 18 18 18 18 18 18 18 18 18 18 18 18 18 18 18 18 18 18 18 18 18 18 18 18 18 18 18 18 18 18 18 18 18 18 18 18 18 18 18 18 18 18 18 18 18 18 18 18 
18 18 18 18 18 18 18 18 18 30 22 1 1 1 1 1 1 14 5 6 3 3 3 3 3 3 7 1 1 1 1 1 1 16 16 16 1 1 1 1 23 18 18 18 18 18 18 18 18 18 18 18 18 18 18 18 18 18 18 18 18 18 18 18 18 18 18 18 18 18 18 18 18 18 18 18 18 18 18 18 18 18 18 18 18 18 18 18 18 18 18 18 18 18 18 18 18 18 18 18 
18 18 18 18 18 18 18 18 18 18 30 21 22 1 1 1 2 1 1 14 5 5 5 5 5 5 15 1 1 1 1 1 1 16 16 16 1 1 1 20 31 18 18 19 18 18 18 18 18 18 18 18 18 18 18 18 18 18 18 18 18 18 18 18 18 18 18 18 18 18 18 18 18 18 18 18 18 18 18 18 18 18 18 18 18 18 18 18 18 18 18 18 18 18 18 18 18 18 18 18 
18 18 18 18 18 18 18 19 18 18 18 18 30 21 22 1 1 1 1 1 1 1 1 1 1 1 1 1 1 1 1 16 16 16 16 1 1 1 1 23 18 18 18 18 18 18 18 18 18 18 18 18 18 18 18 18 18 18 18 18 18 18 18 18 18 18 18 18 18 18 18 18 18 18 18 18 18 18 18 18 18 18 18 18 18 18 18 18 18 18 18 18 18 18 18 18 18 18 18 18 
18 18 18 18 18 18 18 18 18 18 18 18 18 18 30 21 22 1 1 1 1 1 1 1 1 16 16 16 16 16 16 16 16 1 1 1 1 1 20 31 18 18 18 18 18 18 18 18 18 18 18 18 18 18 18 18 18 18 18 18 18 18 18 18 18 18 18 18 18 18 18 18 18 18 18 18 18 18 18 18 18 18 18 18 18 18 18 18 18 18 18 18 18 18 18 18 18 18 18 18 
18 18 18 18 18 18 18 18 18 18 18 18 18 19 18 18 30 21 22 1 1 1 1 1 16 16 16 16 16 16 16 16 1 1 1 2 1 1 23 18 18 18 18 18 18 18 18 18 18 18 18 18 18 18 18 18 18 18 18 18 18 18 18 18 18 18 18 18 18 18 18 18 18 18 18 18 18 18 18 18 18 18 18 18 18 18 18 18 18 18 18 18 18 18 18 18 18 18 18 18 
18 18 19 18 18 18 18 18 18 18 18 18 18 18 18 18 18 18 30 21 21 21 22 1 1 1 1 1 1 1 1 1 1 1 1 1 1 20 31 18 18 18 18 18 18 19 18 18 18 18 18 18 18 18 18 18 18 18 18 18 18 18 18 18 18 18 18 18 18 18 18 18 18 18 18 18 18 18 18 18 18 18 18 18 18 18 18 18 18 18 18 18 18 18 18 18 18 18 18 18 
18 18 18 18 18 18 18 18 19 18 18 18 18 18 18 18 18 18 18 18 18 18 30 21 21 22 1 1 1 1 1 1 1 1 20 21 21 31 18 18 18 18 18 18 18 18 18 18 18 18 18 18 18 18 18 18 18 18 18 18 18 18 18 18 18 18 18 18 18 18 18 18 18 18 18 18 18 18 18 18 18 18 18 18 18 18 18 18 18 18 18 18 18 18 18 18 18 18 18 18 
18 18 18 18 18 18 18 18 18 18 18 18 18 18 18 18 18 19 18 18 18 18 18 18 18 30 21 21 21 21 21 21 21 21 31 18 18 18 18 18 19 18 18 18 18 18 18 18 18 18 18 18 18 18 18 18 18 18 18 18 18 18 18 18 18 18 18 18 18 18 18 18 18 18 18 18 18 18 18 18 18 18 18 18 18 18 18 18 18 18 18 18 18 18 18 18 18 18 18 18 
18 18 18 18 18 18 18 18 18 18 18 18 18 18 18 18 18 18 18 18 18 18 18 18 18 18 18 18 18 18 18 18 18 18 18 18 18 18 18 18 18 18 18 18 18 18 18 18 18 18 18 18 18 18 18 18 18 18 18 18 18 18 18 18 18 18 18 18 18 18 18 18 18 18 18 18 18 18 18 18 18 18 18 18 18 18 18 18 18 18 18 18 18 18 18 18 18 18 18 18 
18 18 18 18 18 18 18 18 18 18 18 18 18 18 18 18 18 18 18 18 19 18 18 18 18 19 18 18 18 18 18 18 18 18 19 18 18 18 18 18 18 18 18 18 18 18 18 18 18 18 18 18 18 18 18 18 18 18 18 18 18 18 18 18 18 18 18 18 18 18 18 18 18 18 18 18 18 18 18 18 18 18 18 18 18 18 18 18 18 18 18 18 18 18 18 18 18 18 18 18 
18 18 18 18 18 18 18 18 18 18 18 18 18 18 18 18 18 18 18 18 18 18 18 18 18 18 18 18 18 18 18 18 18 18 18 18 18 18 18 18 18 18 18 18 18 18 18 18 18 18 18 18 18 18 18 18 18 18 18 18 18 18 18 18 18 18 18 18 18 18 18 18 18 18 18 18 18 18 18 18 18 18 18 18 18 18 18 18 18 18 18 18 18 18 18 18 18 18 18 18 
